4 4 4 4 4 4 4 4 4 4 4 4 4 4 4 4
4 5 5 5 5 5 5 5 5 5 5 5 5 5 5 4
4 1 1 1 1 1 1 1 1 1 1 1 1 1 1 4
4 1 1 1 1 1 1 1 1 1 1 1 1 1 1 4
4 1 1 1 1 1 1 1 1 1 1 1 1 1 1 4
4 1 1 1 1 1 2 2 1 1 1 1 1 1 1 4
4 1 1 1 1 1 2 2 1 1 1 1 1 1 1 4
4 1 1 1 1 1 1 1 1 1 1 1 1 1 1 4
4 1 1 1 1 1 1 1 1 1 1 1 1 1 1 4
4 3 3 3 3 3 3 3 3 3 3 3 3 3 3 4
4 3 3 3 3 3 3 3 3 3 3 3 3 3 3 4
4 4 4 4 4 4 4 4 4 4 4 4 4 4 4 4